00000000000000000000000000000000000000000000000000000000000000000000
00000000000000000000000000000000000000000000000000000000000000000000
00000000000000000000000000000000000000000000000000000000000000000000
00000000000000000000000000000000000000000000000000000000000000000000
00000006000000000000000000000000000000000600000000000000000000006000
00000000000000000000000000000000000000000000000000000000000000000000
00000000000000d1117110000000117111d000000000000000011111140000000000
00000000000000400000000000001111114000000000000000011111140000000000
00000000000000400000000000000000004000000000000000000000040000000000
00000000000000400000111151111000004000000000000111511000040000111181
00000000000000400000000000000000004000000000000111111000040000111181
00000000000000400000000000000000004000000000000000000000040000000000
00000000000000400000000000000000004000000000000000000000040000000000
00000000000000400000000000000000004000000001151110000000041115100000
1111110000000040000000000000000000u111511113111110000000000000000000
00000011111511u00000000000000000000000000000000000000000000000000000
99999999999999999999999999999999999999999999999999999999999999999999